{
  "id": "island_grade1_1",
  "name": "Nivel -1: Las Minas de los Números",
  "width": 16,
  "height": 16,
  "layers": [
    {
      "name": "ground",
      "data": [
        [0,0,0,0,0,0,0,0,0,0,0,0,0,0,0,0],
        [0,2,2,2,2,2,2,0,0,2,2,2,2,2,2,0],
        [0,2,1,1,1,1,2,2,2,2,1,1,1,1,2,0],
        [0,2,1,1,1,1,1,1,1,1,1,1,1,1,2,0],
        [0,2,1,1,2,2,1,1,1,1,2,2,1,1,2,0],
        [0,2,1,1,2,0,0,1,1,0,0,2,1,1,2,0],
        [0,2,1,1,2,0,0,1,1,0,0,2,1,1,2,0],
        [0,2,1,1,1,1,1,1,1,1,1,1,1,1,2,0],
        [0,2,1,1,1,1,1,1,1,1,1,1,1,1,2,0],
        [0,2,1,1,2,0,0,1,1,0,0,2,1,1,2,0],
        [0,2,1,1,2,0,0,1,1,0,0,2,1,1,2,0],
        [0,2,1,1,2,2,1,1,1,1,2,2,1,1,2,0],
        [0,2,1,1,1,1,1,1,1,1,1,1,1,1,2,0],
        [0,2,1,1,1,1,2,2,2,2,1,1,1,1,2,0],
        [0,2,2,2,2,2,2,0,0,2,2,2,2,2,2,0],
        [0,0,0,0,0,0,0,0,0,0,0,0,0,0,0,0]
      ]
    },
    {
      "name": "height",
      "data": [
        [0,0,0,0,0,0,0,0,0,0,0,0,0,0,0,0],
        [0,3,3,3,3,3,3,0,0,3,3,3,3,3,3,0],
        [0,3,0,0,0,0,3,2,2,3,0,0,0,0,3,0],
        [0,3,0,0,0,0,0,0,0,0,0,0,0,0,3,0],
        [0,3,0,0,3,3,0,0,0,0,3,3,0,0,3,0],
        [0,3,0,0,3,0,0,0,0,0,0,3,0,0,3,0],
        [0,3,0,0,3,0,0,0,0,0,0,3,0,0,3,0],
        [0,3,0,0,0,0,0,0,0,0,0,0,0,0,3,0],
        [0,3,0,0,0,0,0,0,0,0,0,0,0,0,3,0],
        [0,3,0,0,3,0,0,0,0,0,0,3,0,0,3,0],
        [0,3,0,0,3,0,0,0,0,0,0,3,0,0,3,0],
        [0,3,0,0,3,3,0,0,0,0,3,3,0,0,3,0],
        [0,3,0,0,0,0,0,0,0,0,0,0,0,0,3,0],
        [0,3,0,0,0,0,3,2,2,3,0,0,0,0,3,0],
        [0,3,3,3,3,3,3,0,0,3,3,3,3,3,3,0],
        [0,0,0,0,0,0,0,0,0,0,0,0,0,0,0,0]
      ]
    }
  ],
  "objects": {
    "npcs": [
        { "id": "miner", "name": "Capataz Numérico", "x": 8, "y": 8, "sprite": "npc_ray_z", "dialogueId": "welcome-grade1" }
    ],
    "props": [
        { "id": "chest_1", "toolId": "", "name": "Cofre Antiguo", "x": 2, "y": 2, "sprite": "sheet" }
    ],
    "portals": [
       { 
         "comment": "Salida hacia el Hub (Superficie)",
         "x": 5, "y": 0, 
         "targetZone": "Hub", 
         "spawnX": -5, "spawnY": -5 
       }
    ],
    "events": []
  }
}